8,12;

 96, 97, 98, 99,100,101,102,103,
128,129,130,131,132,133,134,135,
160,161,162,163,164,165,166,167,

104,105,106,107,108,109,110,111,
136,137,138,139,140,141,142,143,
168,169,170,171,172,173,174,175,

112,113,114,115,116,117,  -,  -,
144,145,146,147,148,149,  -,  -,
176,177,178,179,180,181,  -,  -,

118,119,120,121,122,123,  -,  -,
150,151,152,153,154,155, 90, 91,
182,183,184,185,186,187,  -,  -;

