8,11;

 5, 6, 7,64,65,66,11,12,   
37,38,39,40,41,42,43,44,   
69,70,71,72,73,74,75,76,

67,16,17,68,21,22,23, -,
47,48,49,50,53,54,55, -,
79,80,81,82,85,86,87, -,

56,52,51,46,36,35,34,33,
25,24,20,19,18,15,14,13,

32,31,30,29,28,27, -, -,
10, 9, 8, 4, 3, 2, -, -,

45,77,78,83,84,88,89, -;
