12,6;

 0, 1, 2, 3, 4, 5, 6, 7, 8, 9,10,11,
16,17,18,19,20,21,22,23,24,25,26,27,
32,33,34,35,36,37,38,39,40,41,42,43,
12,13, -, -, -, -,14, -,56,57,58, -,
28,29,30,31,48,49,50,51,59,60,61, -,
44,45,46,47,52,53,54,55,62,63,15, -;

 -, 0, 1, -, -, -,13,14,15, -, -, -, -,
 2, 3, 4, 8, 9,10,16,17,18, -, -, -, -,
 5, 6, 7, -,11,12,19,20,21, -, -, -, -,

22,23,24,31,32,33, -, -, -,42,43, -,50,
25,26,27,34,35,36,39,40,41,44,45,46,51,
28,29,30,37,38, -, -, -, -,47,48,49,52;